1 | 16573 | 0
3 | 60725 | 0
8 | 22691 | 0
9 | 19297 | 0
10 | 11433 | 0
 | 100000 | 0
23 | 8252 | 0
30 | 13442 | 0
33 | 12423 | 0
34 | 10320 | 0
35 | 21708 | 0
36 | 8390 | 0
37 | 8529 | 0
42 | 12050 | 0
63 | 8537 | 0
65 | 8370 | 0
81 | 8066 | 0
