1 | 16573 | 0
3 | 60725 | 0
8 | 22691 | 0
9 | 19297 | 0
10 | 11433 | 0
11 | 6613 | 0
 | 100000 | 0
16 | 4565 | 0
17 | 4603 | 0
23 | 8252 | 0
30 | 13442 | 0
33 | 12423 | 0
34 | 10320 | 0
35 | 21708 | 0
36 | 8390 | 0
37 | 8529 | 0
42 | 12050 | 0
53 | 6444 | 0
60 | 5676 | 0
61 | 5273 | 0
62 | 7596 | 0
63 | 8537 | 0
65 | 8370 | 0
70 | 6359 | 0
74 | 5307 | 0
81 | 8066 | 0
83 | 4662 | 0
86 | 4920 | 0
92 | 6575 | 0
96 | 4704 | 0
98 | 5293 | 0
109 | 5141 | 0
139 | 5450 | 0
157 | 4597 | 0
172 | 6011 | 0
229 | 4787 | 0
